10
9
  ####
  #--#####
###-.#---#
#@--$----#
#-##*#####
#---$--#
###-.--#
  #--###
  ####